8
XXXXX...
XXX.....
XX11X...
XX.XXXXX
XX1.1XXX
XXXX.XXX
..X..XXX
..1.XXXX
7 0 0
1 6
