9
....D....
.........
D........
.....D...
.........
.........
.........
X.XXXXXXX
X.......D
0 8 2
8 7
