9
DDDDDDDDD
D.......D
D.DDDDD.D
D.D...D.D
D.D.DDD.D
D.D.....D
D.DDDDDDD
D.......D
DDDDDDDDD
7 7 2
3 5
