8
XXXXXXXX
X1.1111X
11111111
11.111.1
11111111
11111111
X.1111.X
XXXXXXXX
6 1 0
1 2
