9
XDDD.DDDX
X..DDD..X
X.......X
X.......X
X.......X
X.......X
X.......X
X.......X
X.......X
8 4 3
0 4
